Brake Redpoint,,,,,,,
7,8,2,,,,,
0,0,1,1,1,1,0,0
0,0,0,0,0,0,0,0
1,1,0,0,0,0,1,1
0,0,0,3,3,0,0,0
0,0,1,2,2,1,0,0
0,0,0,0,0,0,0,0
1,1,0,0,0,0,1,1
dagger,,,,,,,
1,400,1,100,,,,
