FUN,,,,,,,,,,
8,11,4,,,,,,,,
0,0,0,0,0,0,0,0,0,0,0
1,1,0,1,0,1,0,1,0,0,1
3,0,0,1,0,1,0,1,3,0,1
1,1,0,1,0,1,0,1,1,3,1
1,0,0,1,0,1,0,1,0,1,1
1,0,0,0,3,0,0,1,,0,1
0,0,0,0,0,0,0,0,0,0,0
0,0,0,0,0,0,0,0,0,0,0
dagger,,,,,,,,,,
1,200,0,400,1,300,0,100,,,
