Random Map
6,7,2
1,3,3,0,3,0,1
1,2,0,1,0,0,0
0,3,3,3,3,0,2
1,3,2,2,3,2,1
2,2,0,3,1,0,2
0,2,1,1,0,0,3
dagger
0,137,0,336
